Oradea, Zerind, Arad, Timisoara, Loguj, Mehadia, Dobreta, Sibiu, Rimnicu Vilcea, Craiova, Fagaras, Pitesti, Bucharest, Giurgiu, Urziceni, Neamt, Lasi, Vaslui, Hirsova, Eforie
0, 71, -1, -1, -1, -1, -1, 151, -1, -1, -1, -1, -1, -1, -1, -1, -1, -1, -1, -1
71, 0, 75, -1, -1, -1, -1, -1, -1, -1, -1, -1, -1, -1, -1, -1, -1, -1, -1, -1
-1, 75, 0, 118, -1, -1, -1, 140, -1, -1, -1, -1, -1, -1, -1, -1, -1, -1, -1, -1
-1, -1, 118, 0, 111, -1, -1, -1, -1, -1, -1, -1, -1, -1, -1, -1, -1, -1, -1, -1
-1, -1, -1, 111, 0, 70, -1, -1, -1, -1, -1, -1, -1, -1, -1, -1, -1, -1, -1, -1
-1, -1, -1, -1, 70, 0, 75, -1, -1, -1, -1, -1, -1, -1, -1, -1, -1, -1, -1, -1
-1, -1, -1, -1, -1, 75, 0, -1, -1, 120, -1, -1, -1, -1, -1, -1, -1, -1, -1, -1
151, -1, 140, -1, -1, -1, -1, 0, 80, -1, 99, -1, -1, -1, -1, -1, -1, -1, -1, -1
-1, -1, -1, -1, -1, -1, -1, 80, 0, 146, -1, 97, -1, -1, -1, -1, -1, -1, -1, -1
-1, -1, -1, -1, -1, -1, 120, -1, 146, 0, -1, 138, -1, -1, -1, -1, -1, -1, -1, -1
-1, -1, -1, -1, -1, -1, -1, 99, -1, -1, 0, -1, 211, -1, -1, -1, -1, -1, -1, -1
-1, -1, -1, -1, -1, -1, -1, -1, 97, 138, -1, 0, 101, -1, -1, -1, -1, -1, -1, -1
-1, -1, -1, -1, -1, -1, -1, -1, -1, -1, 211, 101, 0, 90, 85, -1, -1, -1, -1, -1
-1, -1, -1, -1, -1, -1, -1, -1, -1, -1, -1, -1, 90, 0, -1, -1, -1, -1, -1, -1
-1, -1, -1, -1, -1, -1, -1, -1, -1, -1, -1, -1, 85, -1, 0, -1, -1, 142, 98, -1
-1, -1, -1, -1, -1, -1, -1, -1, -1, -1, -1, -1, -1, -1, -1, 0, 87, -1, -1, -1
-1, -1, -1, -1, -1, -1, -1, -1, -1, -1, -1, -1, -1, -1, -1, 87, 0, 92, -1, -1
-1, -1, -1, -1, -1, -1, -1, -1, -1, -1, -1, -1, -1, -1, 142, -1, 92, 0, -1, -1
-1, -1, -1, -1, -1, -1, -1, -1, -1, -1, -1, -1, -1, -1, 98, -1, -1, -1, 0, 86
-1, -1, -1, -1, -1, -1, -1, -1, -1, -1, -1, -1, -1, -1, -1, -1, -1, -1, 86, 0
